NO ./textures/north.xpm
SO ./textures/south.xpm
WE ./textures/west.xpm
EA ./textures/east.xpm

F 220,100,0
C 225,230,255

11111111111111111111111111111111111111111111111111111111111111111111111111
10000000000000000000000000000000000000000000000000000000000000000000000001
10000000000000000111111111111111111000000000000000000000000000000000000001
10000000000000000000000000000000000111111111111110000000000000000000000001
10000000000000111110000000000000000111111111111111110000000000000000000001
10000000000000111111111110000000000111111111111111110000000000000000000001
10000000000000111111111111111111000111111111111111110000000000000000000001
10000000000000111111111111111111000111111111111111110000000000000000000001
10000000000000111111111111111111000111111111111111110000000000000000000001
10000000000000000000000000000000000111111111111111110000000000000000000001
10000000000000000000000000000000000000000000000000000000000000000000000001
10000000111111111111000000000000000000000000000000000000000000000000000001
10000000111111111111000000000000000111111111111111110000000000000000000001
10000000111111111111000000000000000111111111111111110000000000000000000001
10000000111111111111000000000000000111111111111111110000000000000000000001
10000000111111111111000000000000000111111111111111110000000000000000000001
10000000111111111111000000000000000111111111111111110000000000000000000001
10000000000000000000000000000000000111111111111111110000000000000000000001
10000000000000000000000000000000000111111111111111110000000000000000000001
10000000000000000000000000000000000111111111111111110000000000000000000001
10000000000000000000000000000000000000000000000000000000000000000000000001
10000000000000000000000000000000000111111111111111110000000000000000000001
10000000000000000000000000000000000111111111111111110000000000000000000001
10000000000000000000000000000000000111111111111111110000000000000000000001
10000000000000000000000000000000000111111111111111110000000000000000000001
10000000000000000000000000000000000111111111111111110000000000000000000001
10000000000011111111111111111111111111111111111111111111111111111111100001
10000000000000000000000000000000000000000000000000000000000000000000000001
10W00000000000000000000000000000000000000000000000000000000000000000000001
10000000000000000000000000000000000000000000000000000000000000000000000001
10000000111111111111111111111111000000000000000000000000000000000000000001
10000000000000000000000000000000000111111111111111110000000000000000000001
10000000000000000000000000000000000111111111111111110000000000000000000001
10000000000000000000000000000000000111111111111111110000000000000000000001
10000000000000000000000000000000000111111111111111110000000000000000000001
10000000000000000000000000000000000111111111111111110000000000000000000001
10000000000000000000000000000000000111111111111111110000000000000000000001
10000000000000000000000000000000000111111111111111110000000000000000000001
11111111111111111111111111111111111111111111111111111111111111111111111111
